+---+---+---+---+---+---+---+
|       |   |       |       |
+---+   +---+---+---+---+---+
|   |       |       |   |   |
+---+---+---+   +   +   +   +
| #     |       |   |   |   |
+---+---+---+---+---+---+   +
|               |   |       |
+   +---+---+---+   +---+---+
|   |   |       |   |       |
+   +---+---+   +   +   +---+
|       |   |   |   |       |
+---+---+   +---+   +---+   +
| #   #     |       |   |   |
+---+---+---+   +---+   +---+
|           |       |       |
+---+---+---+---+---+---+   +
|         #   #   #   # |   |
+---+---+---+---+---+---+---+

+---+---+---+---+---+---+---+
|           |   |       |   |
+   +---+---+   +---+---+   +
|       |       |   |       |
+---+   +---+---+---+---+---+
| # |   |   |       |       |
+   +---+   +---+   +---+   +
| # |       |   |       |   |
+   +---+---+---+---+---+   +
| #     |               |   |
+   +---+---+---+---+   +---+
| # |       |       |       |
+   +---+   +---+   +   +---+
| # | # |   |   |   |       |
+---+   +   +   +   +---+---+
|   | # |   |   |   |   |   |
+   +   +---+   +---+---+   +
|   | #   #   #   #   #     |
+---+---+---+---+---+---+---+

