+---+---+---+---+---+---+---+---+---+---+---+---+
|   |   |       |   |           |   |   |   |   |
+---+   +---+---+   +---+---+---+---+   +   +   +
|   |       | #   #   # |   |       |   |   |   |
+   +---+   +   +---+---+---+---+---+---+---+   +
|           | # |   | #   #     | #   # |       |
+   +---+---+---+---+---+---+---+   +   +   +---+
|   |                   |   | # | # | # |       |
+---+---+---+---+---+   +   +   +   +   +---+---+
|       |       |       |   | #   # | #   #   # |
+   +---+---+---+---+---+   +---+---+---+---+   +
|       |       |           |       | #   #   # |
+---+   +   +---+---+---+   +---+---+---+---+---+
|       |   |           |                       |
+---+---+---+---+---+---+---+---+---+---+---+---+

+---+---+---+---+---+---+---+---+---+---+---+---+
|   |   |   |           | # |   |   |       |   |
+   +   +---+---+---+---+   +   +   +---+---+---+
|   |   |   | #   # | # | # |   |   |   |       |
+   +---+   +   +---+   +   +---+   +   +---+   +
|       |   | # |   | # | # |       |   |       |
+---+---+---+---+   +---+   +---+---+---+   +---+
|   |   |           |   | # | # |       |   |   |
+   +---+   +---+---+   +   +   +   +   +---+   +
|   |   |   |   |       | #   # |   |           |
+   +---+---+   +---+---+---+---+---+---+---+---+
|   |   |   |   |           |   |   | # | #   # |
+   +   +---+---+---+---+   +---+---+---+   +---+
|   |   |   |   |   |       |   |   |       |   |
+---+---+---+---+---+---+---+---+---+---+---+---+

+---+---+---+---+---+---+---+---+---+---+---+---+
|   |   |       |     #   # |   |   |   |       |
+   +---+---+---+---+   +---+   +   +   +---+---+
|       |       | #   # |       |   |   |       |
+   +---+---+---+---+---+   +---+   +---+   +---+
|   |   |       |       |       |   |       |   |
+---+---+   +---+---+---+---+---+   +---+---+   +
|   |   |           |               | # |       |
+   +---+---+---+   +---+---+---+---+   +---+---+
|   |       |   |       |   |   |   | # | #   # |
+---+   +---+   +---+   +   +   +   +   +   +---+
|   |   |   |   |   |   |   |   |   | # | #   # |
+   +---+---+---+   +---+   +---+   +---+---+---+
|       |   |   |   |   |       |   |   |       |
+---+---+---+---+---+---+---+---+---+---+---+---+

+---+---+---+---+---+---+---+---+---+---+---+---+
|   |       |                   |       |       |
+   +   +---+---+---+---+---+---+---+---+---+---+
|   |   |                           |           |
+   +---+   +---+---+---+   +---+---+---+---+---+
|   |   |           |       |                   |
+   +   +---+---+---+---+---+---+---+---+---+---+
|   |   |   |                       | #   #   # |
+---+---+   +   +---+---+---+---+   +---+---+   +
|       |   |   |   |           |           | # |
+---+   +---+---+   +   +---+---+---+   +---+---+
|       |           |   |           |           |
+   +---+---+---+---+---+---+---+   +---+---+   +
|   |       |                   |   |       |   |
+---+---+---+---+---+---+---+---+---+---+---+---+

+---+---+---+---+---+---+---+---+---+---+---+---+
|   |   | #   # |   | #   #   # |   |   |   |   |
+---+   +---+---+   +---+---+---+---+   +   +   +
|   |       | #   #   # |   | #   # |   |   |   |
+   +---+   +   +---+---+---+---+---+---+---+   +
|           | # |   | #   #   # | #   # |       |
+   +---+---+---+---+---+---+---+   +   +   +---+
|   |                   |   | # | # | # |       |
+---+---+---+---+---+   +   +   +   +   +---+---+
|       | #   # |       |   | #   # | #   #   # |
+   +---+---+---+---+---+   +---+---+---+---+   +
|       |       | #   #   # | #   # | #   #   # |
+---+   +   +---+---+---+   +---+---+---+---+---+
|       |   |           | #   #                 |
+---+---+---+---+---+---+---+---+---+---+---+---+

+---+---+---+---+---+---+---+---+---+---+---+---+
|   |   | # | #   #   # | # | # |   |       |   |
+   +   +---+---+---+---+   +   +   +---+---+---+
|   |   |   | #   # | # | # | # | # |   |       |
+   +---+   +   +---+   +   +---+   +   +---+   +
|       |   | # | # | # | # | #   # |   |       |
+---+---+---+---+   +---+   +---+---+---+   +---+
|   |   | #   #   # |   | # | # |       |   |   |
+   +---+   +---+---+   +   +   +   +   +---+   +
|   |   | # | # |       | #   # |   |           |
+   +---+---+   +---+---+---+---+---+---+---+---+
|   |   |   | # | #   #   # | # | # | # | #   # |
+   +   +---+---+---+---+   +---+---+---+   +---+
|   |   |   |   |   | #   # | # |   | #   # |   |
+---+---+---+---+---+---+---+---+---+---+---+---+

+---+---+---+---+---+---+---+---+---+---+---+---+
|   |   | #   # |     #   # | # |   |   |       |
+   +---+---+---+---+   +---+   +   +   +---+---+
|       |       | #   # |     # |   |   |       |
+   +---+---+---+---+---+   +---+   +---+   +---+
|   |   | #   # | #   # |       |   |       |   |
+---+---+   +---+---+---+---+---+   +---+---+   +
|   |   | #   #   # |               | # |       |
+   +---+---+---+   +---+---+---+---+   +---+---+
|   |       | # | #   # |   | # |   | # | #   # |
+---+   +---+   +---+   +   +   +   +   +   +---+
|   |   |   | # |   | # | # | # | # | # | #   # |
+   +---+---+---+   +---+   +---+   +---+---+---+
|       |   |   |   | # | #   # | # | # | #   # |
+---+---+---+---+---+---+---+---+---+---+---+---+

+---+---+---+---+---+---+---+---+---+---+---+---+
|   |       | #   #   #   #   # |       |       |
+   +   +---+---+---+---+---+---+---+---+---+---+
|   |   | #   #   #   #   #         |           |
+   +---+   +---+---+---+   +---+---+---+---+---+
|   |   | #   #     | #   # |                   |
+   +   +---+---+---+---+---+---+---+---+---+---+
|   |   |   | #   #   #   #   #   # | #   #   # |
+---+---+   +   +---+---+---+---+   +---+---+   +
|       |   | # |   | #   #   # | #   #     | # |
+---+   +---+---+   +   +---+---+---+   +---+---+
|       |           | # | #   #   # | #   #   # |
+   +---+---+---+---+---+---+---+   +---+---+   +
|   |       |     #   #         | # | #   # | # |
+---+---+---+---+---+---+---+---+---+---+---+---+

