+---+---+---+---+---+---+---+---+---+
|   |       | #   # | #   # | # |   |
+---+---+   +   +   +---+---+   +   +
|       | # | # | #   #   #   # |   |
+---+---+---+---+---+---+---+---+---+

+---+---+---+---+---+---+---+---+---+
|       | #   #   # | # | # | # |   |
+---+---+---+---+   +   +---+   +   +
| #   #   # | # | #   # |     # |   |
+---+---+---+---+---+---+---+---+---+

+---+---+---+---+---+---+---+---+---+
|   |     # |   | #   # | # | #     |
+---+---+---+   +---+---+   +   +---+
| #   #   # | #   #     | # | # |   |
+---+---+---+---+---+---+---+---+---+

+---+---+---+---+---+---+---+---+---+
|       | #   # | # | # |           |
+   +---+---+   +   +   +---+   +---+
|       | #   # | # | #   # |       |
+---+---+---+---+---+---+---+---+---+

+---+---+---+---+---+---+---+---+---+
|   |       |       |       |   |   |
+---+---+   +   +   +---+---+   +   +
|       |   |   |               |   |
+---+---+---+---+---+---+---+---+---+

+---+---+---+---+---+---+---+---+---+
|       |           |   |   |   |   |
+---+---+---+---+   +   +---+   +   +
|           |   |       |       |   |
+---+---+---+---+---+---+---+---+---+

+---+---+---+---+---+---+---+---+---+
|   | #   # |   |       |   |       |
+---+---+---+   +---+---+   +   +---+
|     #   # |           |   |   |   |
+---+---+---+---+---+---+---+---+---+

+---+---+---+---+---+---+---+---+---+
|       | #   # |   |   |           |
+   +---+---+   +   +   +---+   +---+
|       | #   # |   |       |       |
+---+---+---+---+---+---+---+---+---+

