+---+---+---+---+---+---+---+---+---+---+---+---+---+---+---+
| X   X   X   F | F | F | F   F   X   X   X | F | F   X   X |
+---+---+---+---+   +   +---+   +---+---+---+   +   +---+---+
| X   F | F   F | F | X   X   X | X   X   X   X | X | X   F |
+   +---+---+   +---+   +---+---+   +---+---+---+---+   +---+
| X | X   X | X | F | X   F   X | X | F   X | F | F   X | F |
+   +   +   +---+   +---+---+   +   +---+   +   +---+---+   +
| X | X | X   X   X | X   F | X | X   X | X | X   X   F | F |
+   +   +---+---+---+   +---+---+---+   +---+---+---+---+---+
| X | X | F   F | F   X | F   X | F | X | F   F | F | F   X |
+   +   +---+---+---+---+---+   +---+   +---+---+   +---+   +
| X   X | F | X   F | X   F | F | X   X   X   X | X | X   X |
+---+---+   +   +---+---+---+---+   +---+---+   +   +   +---+
| F   F | F | X   X   X   X   F | F | F   F | X | X | X   X |
+---+---+---+---+---+---+---+---+   +---+---+   +   +---+   +
| X   F   X | F   F | X   X   X   X | F | X   X   X   X | X |
+   +---+---+---+---+   +---+---+---+   +---+---+---+---+   +
| X   F | F   X   X   X | X   F   X | X   X   X   X   F   X |
+---+---+---+---+---+---+---+---+---+---+---+---+---+---+---+

+---+---+---+---+---+---+---+---+---+---+---+---+---+---+---+
| X   X   X | B   B | B |   |   | F | X   X |   |   | F   F |
+   +---+   +---+---+---+---+---+   +   +   +---+---+---+   +
| X | B | B | B | B   X | X | X   X | X | X   F   F   X | B |
+   +   +---+   +---+   +   +   +---+   +---+---+---+---+---+
| X | X   F | X   B | F |   | X   X   B | F | B |   | X   B |
+   +---+---+---+---+---+---+---+---+---+   +   +---+   +---+
| X | F   X   X   X   F | B   F | F | F | F | F | F | B | B |
+   +---+---+---+---+   +---+---+   +   +---+---+   +---+   +
| X | X   B | B |   | F |   | F |   | F |   |   | B | B   X |
+   +   +---+   +---+---+---+---+---+---+---+---+   +---+---+
| X   X |   | F | B   F |   | B   F | X   X   X | X   X   F |
+---+---+---+---+---+---+---+---+---+   +---+   +   +---+---+
| B | B   B | F   X   X   X |   |   | B |   | X | F | F | F |
+   +---+---+---+---+---+   +---+---+---+---+   +---+   +   +
| X |   | F   B | B | F   X | F   X |   | F | X | F   X | F |
+   +---+---+---+   +   +---+---+   +---+   +   +---+---+---+
| F | B | B   X   X | X   X   B | F | F   X | F   F | B   F |
+---+---+---+---+---+---+---+---+---+---+---+---+---+---+---+

+---+---+---+---+---+---+---+---+---+---+---+---+---+---+---+
| X   X   X | X   X   X   B | B | B | X   X | B | B | B | B |
+   +---+   +   +   +---+---+---+   +   +   +   +   +   +---+
| X | X   X | X | X   X   X   X   X | X | X | B | B | X   X |
+   +   +---+   +---+---+---+---+---+   +---+---+---+---+   +
| X | X   B | X | X   B | B   X   X | X | B   X   B | X   X |
+   +---+---+   +   +---+---+---+   +   +---+---+---+   +---+
| X | B   X | X | X | B | X   B | B | B | B | B | B | X | X |
+   +---+   +   +   +---+   +---+---+---+   +   +   +   +   +
| X | X | X | X | B | B | B | B   B   B | B | B | X | X | X |
+   +   +   +---+---+   +---+---+---+   +---+---+---+   +   +
| X | X | B | B   X | B | B | X   B | X   X | X   X   X | B |
+   +   +---+---+   +---+   +   +---+   +---+   +---+---+---+
| X | X | X   B | X | X   X | B | B | X | B   X | B | B   B |
+   +   +   +   +   +---+   +---+   +---+---+---+---+---+---+
| X | B | B | X | X | B   X | B | X   B | B   X   B | X   B |
+   +   +---+   +   +---+---+   +---+---+---+---+---+   +---+
| B | X   X   X | X   X   X   X | B   B | X   B | B   X | B |
+---+---+---+---+---+---+---+---+---+---+---+---+---+---+---+

