+---+---+---+---+---+
|   | #   #   # |   |
+   +   +---+---+   +
|   | # |   |       |
+   +---+---+   +---+
|   |       |       |
+   +---+   +---+   +
|       |           |
+---+   +---+---+   +
|   |   |           |
+---+---+---+---+---+

+---+---+---+---+---+
|   |   | #   # |   |
+   +---+---+---+   +
|     # |           |
+---+---+---+   +---+
|       |   |   | # |
+---+---+   +   +   +
|       |   |   | # |
+---+---+   +---+   +
|   |       | #   # |
+---+---+---+---+---+

+---+---+---+---+---+
|   |   | #   # |   |
+   +   +---+   +---+
|   |       | #   # |
+   +   +---+---+   +
|   |   |       | # |
+---+   +---+   +---+
|   |   |   |     # |
+   +---+   +---+   +
|           | #   # |
+---+---+---+---+---+

+---+---+---+---+---+
|   |           |   |
+   +   +---+---+   +
|   |   |   |       |
+   +---+---+   +---+
|   |       |       |
+   +---+   +---+   +
|       |           |
+---+   +---+---+   +
|   |   |           |
+---+---+---+---+---+

+---+---+---+---+---+
|   |   |       |   |
+   +---+---+---+   +
|       |           |
+---+---+---+   +---+
|       |   |   | # |
+---+---+   +   +   +
|       |   |   | # |
+---+---+   +---+   +
|   |       | #   # |
+---+---+---+---+---+

+---+---+---+---+---+
|   |   |       |   |
+   +   +---+   +---+
|   |       | #   # |
+   +   +---+---+   +
|   |   |       | # |
+---+   +---+   +---+
|   |   |   |       |
+   +---+   +---+   +
|           | #   # |
+---+---+---+---+---+

