+---+---+---+---+---+---+---+---+
| X | X   X   X   F | F | F | F |
+   +---+---+---+---+   +   +---+
| X   X   F | F | F | X | X   X |
+---+---+---+   +   +   +---+   +
| X | F | X   X | X   X | F   X |
+   +   +---+   +---+---+---+---+
| X | F | X   X | X   X | X   X |
+   +---+   +---+   +   +   +   +
| X   F | F | X   X | X | X | X |
+   +---+---+   +---+   +   +   +
| X   F | F | F | X | X | X | X |
+---+---+   +---+   +   +   +   +
| X | F   X | F | X | X | X | F |
+   +---+---+   +   +   +   +---+
| F | F   X   X | F | F | X | F |
+---+---+---+---+   +---+   +---+
| X   F | F   X   F   X | X   X |
+   +---+---+   +---+   +---+   +
| X | F   X | X | F | X   X | F |
+   +---+   +---+   +---+   +---+
| X   X | F | F | X   F | X   X |
+   +---+---+   +---+---+---+   +
| F | X   X | F | F | X   F | F |
+   +   +   +---+---+   +---+---+
| X | X | X   X   X | X | F   X |
+   +   +---+---+   +   +---+   +
| X | F | F   F | X   X | X   F |
+---+---+---+---+---+---+---+---+

+---+---+---+---+---+---+---+---+
| F | F   F | F |     B | B   B |
+   +---+---+   +---+---+---+   +
| X | F | B | B | B   X   X   X |
+   +---+   +---+---+---+---+   +
| F | B   X | X   F | F | B | X |
+---+---+---+   +---+---+   +   +
| F | B   F | X   F | X   X | X |
+   +---+---+---+---+   +---+---+
| F |   | B   X   X | X   X   X |
+---+---+---+---+   +---+---+   +
| X   B | B |   | X | X   X   X |
+   +---+   +---+   +   +---+---+
| X   B | X | B   X | X   X   B |
+---+---+   +---+---+---+---+---+
| B |   | F | F   B |   | X   B |
+   +---+---+---+---+---+   +   +
| X |     B | F |   | F   X | X |
+   +---+   +   +---+---+   +---+
| X |   | X | F | B   F | F | B |
+   +---+---+---+---+---+---+   +
| F | X   B | B   X   B | F | X |
+   +   +---+---+---+---+   +   +
| B | F | F |   |     F | B | B |
+---+---+---+---+---+   +---+---+
| F | F | F | X   X | X | B | X |
+   +---+   +   +   +   +   +   +
| F |   | B | B | F | F | F | B |
+---+---+---+---+---+---+---+---+

+---+---+---+---+---+---+---+---+
|   |   |   | B |   | X   F   F |
+---+---+---+   +---+   +---+   +
| F |     X | F | F | F | F | X |
+---+---+   +---+---+---+   +---+
| B   F | F | F   B |   | X | F |
+---+---+---+---+---+---+   +   +
| B   X   B | X | B   X | X | X |
+---+---+---+   +---+   +   +   +
| B | B | X   X   F | F | F | F |
+   +   +   +---+---+---+---+---+
| F | X | X | B   X | F | X   X |
+---+   +---+---+   +   +   +   +
| F | X   X   X   X | X | F | X |
+   +---+---+---+---+   +---+   +
| X |   | B | B   X | B | X   X |
+   +---+   +---+---+---+   +---+
| X |   | F |   | B | B | X   X |
+   +---+---+---+   +---+---+   +
| F | B   X |   | F |   |   | X |
+---+---+   +---+---+---+---+   +
| B   X | X   X | F   X   B | F |
+---+---+---+   +---+---+---+---+
| F   B |   | B | B | B | F   X |
+---+---+---+---+   +---+---+   +
|   |   | B | F | X   X   X   X |
+---+---+   +   +---+---+---+---+
|   |   | X   X |   |   | B   F |
+---+---+---+---+---+---+---+---+

+---+---+---+---+---+---+---+---+
| B   B | B | X   B   X   B | B |
+---+---+   +---+---+---+---+---+
| B   B | X   B | B   B | B   X |
+   +---+---+---+   +---+---+   +
| X | B | B | B | X   B   X | B |
+   +   +   +   +   +---+---+---+
| X | X   X | X | X | X   X | X |
+   +---+---+   +   +   +   +   +
| X   X   X   X | B | B | B | B |
+---+---+---+---+   +---+---+   +
| B   X   X   X | X | B   X   X |
+---+---+---+   +   +---+---+---+
| B | X   X | X | X   X   B | X |
+   +---+   +   +---+---+---+   +
| X   B | X | X   X | X   X   X |
+---+---+   +---+   +---+---+   +
| X   B | B   B | X   X | X   X |
+---+   +---+---+---+   +   +   +
| B | X   X | B   B | B | B | X |
+   +---+---+---+---+---+   +---+
| X   X   X   X   B | X   X   B |
+---+---+---+---+---+   +---+---+
| B | X   B   X   X | X | B | X |
+   +   +   +---+   +   +   +   +
| B | B | X | B | X | X   X | X |
+---+---+   +   +---+---+---+   +
| B   B | X   X | B   B   X   B |
+---+---+---+---+---+---+---+---+

