+---+---+---+
| X | X   X |
+   +---+   +
| X | F   X |
+   +---+---+
| F | F   F |
+---+---+---+

+---+---+---+
| F | F   X |
+---+---+   +
| F   B | F |
+---+   +---+
|   | B |   |
+---+---+---+

+---+---+---+
| B | B | X |
+   +   +   +
| B | X | B |
+---+   +   +
| B   X | B |
+---+---+---+

