+---+---+---+---+---+---+---+---+
|       |   |   |               |
+---+   +   +   +---+---+---+   +
|   |       |           |   |   |
+---+---+---+---+---+   +   +   +
|   |                   |       |
+   +---+---+---+---+   +---+---+
|   |   |       |   |       |   |
+   +   +---+   +   +---+---+   +
|   |       |   |       | #   # |
+---+---+---+---+---+---+   +   +
|       |   |           | # | # |
+---+   +---+---+---+   +---+---+
|       |   |   |       |       |
+---+---+   +   +   +   +---+   +
|       |   |   |   |       | # |
+   +---+   +---+---+---+---+   +
|   |   |                   | # |
+   +   +---+---+---+---+   +---+
|   |   |               |       |
+   +   +---+---+---+---+---+   +
|   |   |       |       |       |
+   +   +---+   +---+   +---+---+
|   |   |       |       |       |
+   +---+---+---+   +---+   +   +
|   |           |       |   |   |
+   +   +---+---+---+---+   +   +
|   |   |                   |   |
+---+---+---+---+---+---+---+---+

+---+---+---+---+---+---+---+---+
|       |   |   |   |       |   |
+---+---+---+   +---+---+---+   +
|           |           |   |   |
+   +---+   +---+---+---+---+   +
|   |   |               |   |   |
+---+---+---+---+---+   +---+   +
|       |           |   | # |   |
+---+---+---+---+---+---+   +   +
|   |       |   |   | #   # |   |
+---+---+---+---+---+---+---+---+
|   |       |   |   | #   # | # |
+---+---+---+---+   +---+---+---+
|   |   |   |       |   |       |
+   +   +   +---+---+---+---+---+
|   |   |   |       |   | #   # |
+   +---+   +   +---+   +   +---+
|       |       |   |   | #   # |
+---+---+---+---+   +---+---+---+
|   |       |   |   |       |   |
+---+   +---+   +---+   +---+---+
|   |       |   |   |           |
+   +---+---+   +---+---+---+   +
|   |   |       |               |
+---+   +---+---+---+---+---+---+
|       |       |   |       |   |
+   +---+---+---+   +---+---+   +
|       |   |   |           |   |
+---+---+---+---+---+---+---+---+

+---+---+---+---+---+---+---+---+
|   |       |   |       |       |
+   +---+---+---+---+---+---+---+
|   |                       |   |
+   +   +---+---+---+---+---+   +
|   |   |                       |
+   +---+---+---+   +---+---+---+
|   |               |           |
+   +---+   +---+---+---+---+   +
|   |   |       |   | #   # |   |
+---+   +---+---+   +---+   +---+
|       |       |   | #   # | # |
+---+---+   +---+   +---+---+   +
|   |   |       |       |   | # |
+   +   +---+---+   +---+   +   +
|       |           |       | # |
+---+---+   +---+---+---+---+---+
|       |       |   |           |
+   +---+---+   +---+---+---+   +
|       |       |               |
+---+---+---+---+   +---+---+---+
|       |       |   |       |   |
+---+   +---+---+---+---+   +   +
|               |   |           |
+   +---+---+   +   +   +---+---+
|       |   |       |   |   |   |
+---+   +   +---+---+   +   +   +
|       |   |       |   |       |
+---+---+---+---+---+---+---+---+

