+---+---+---+---+---+---+---+---+
| X | X   X | F   F | X   F | F |
+   +   +   +---+---+   +---+   +
| F | X | X   X | X   X | F   X |
+---+   +---+   +   +---+---+---+
| X   X | X   X | X   X   X   F |
+   +---+   +---+---+---+---+---+
| X   X | X | F | F   X   X   F |
+---+   +   +---+---+---+---+   +
| X   X | X   X   X   F | F | X |
+   +---+---+---+   +---+   +   +
| X   F | X   X   X | F   X | X |
+---+---+---+---+---+---+---+---+

+---+---+---+---+---+---+---+---+
| X   X | X   B | B   X |   | B |
+   +   +   +---+---+   +---+   +
| B | X | F | F | F   F   B | X |
+---+   +---+   +---+---+---+---+
| X   X | F | X   X | F | X   B |
+   +---+   +   +---+   +   +---+
| F | X   F   B | B | X | X   B |
+---+   +---+---+   +   +---+---+
| F   X | F   X | F | B | B   X |
+---+---+---+   +---+---+---+   +
| F | B   F | X   X   B | F   X |
+---+---+---+---+---+---+---+---+

+---+---+---+---+---+---+---+---+
| F | F | F   X | F   F |   | F |
+   +---+---+   +---+---+---+   +
| X | X   B | B |   | B | F   X |
+   +   +---+---+---+---+---+---+
| F | X   B | X   X   B | F | X |
+---+---+---+   +---+---+   +   +
| B   X | B | X   F | F | X | F |
+---+   +---+---+---+   +   +   +
| B | X |   | F |   | F | F | X |
+   +   +---+   +---+---+---+   +
| B | F |   | X   X | F   B | F |
+---+---+---+---+---+---+---+---+

+---+---+---+---+---+---+---+---+
| B     | B | F   B | B |   | B |
+---+---+   +---+---+   +---+   +
| X   F | F | F |   | X |   | X |
+---+---+---+   +---+   +---+   +
| B   X   X   X | X   X | B | X |
+---+---+---+---+   +   +   +   +
| X   X   X | F | B | B | F | B |
+   +---+   +   +---+---+---+---+
| X | F | B | B |   | B | B | F |
+   +   +---+---+---+---+   +   +
| F | B | B   X   F | B   X | B |
+---+---+---+---+---+---+---+---+

+---+---+---+---+---+---+---+---+
| X   B   X | B   X   X | B   X |
+   +---+---+---+---+   +---+   +
| X   B | B   B | B   X | B   X |
+---+   +---+---+---+---+---+---+
| X   X   X   X   X   X   X   X |
+---+---+---+---+   +---+---+   +
| X   X   X | B   X | X   B | X |
+   +---+   +---+---+   +---+---+
| X | B | X   X | B   X | X   B |
+   +   +---+   +---+---+   +---+
| B | X   X   X | B   X   X   X |
+---+---+---+---+---+---+---+---+

