+---+---+---+---+---+
|     #   #   #   # |
+---+---+---+---+   +
|             #   # |
+---+---+---+---+---+

