+---+---+---+---+---+---+---+---+---+---+
|   |   |               | #   # |       |
+   +   +   +---+---+---+---+---+   +   +
|       |       | #   #   #   #     |   |
+---+---+---+---+---+---+---+---+---+---+

+---+---+---+---+---+---+---+---+---+---+
|   |   |       |   | #   # | # | #   # |
+   +---+   +---+---+---+---+---+---+   +
|       |         #   #   # | # |   | # |
+---+---+---+---+---+---+---+---+---+---+

+---+---+---+---+---+---+---+---+---+---+
|   |   |   |       | # | #   # | #     |
+   +---+   +---+   +---+   +---+   +---+
|   |       |       |   | # | #   # | # |
+---+---+---+---+---+---+---+---+---+---+

+---+---+---+---+---+---+---+---+---+---+
|   |           |     # | #   #   # |   |
+   +---+---+---+---+   +   +---+   +---+
|           |     #   # | # |   | #   # |
+---+---+---+---+---+---+---+---+---+---+

+---+---+---+---+---+---+---+---+---+---+
|   | # |               | #   # |       |
+   +   +   +---+---+---+---+---+   +   +
|     # |       |                   |   |
+---+---+---+---+---+---+---+---+---+---+

+---+---+---+---+---+---+---+---+---+---+
|   | # |       |   | #   # | # | #   # |
+   +---+   +---+---+---+---+---+---+   +
|       |                   |   |   | # |
+---+---+---+---+---+---+---+---+---+---+

+---+---+---+---+---+---+---+---+---+---+
|   | # |   | #   # | # | #   # |       |
+   +---+   +---+   +---+   +---+   +---+
|   |       | #   # |   | # |       | # |
+---+---+---+---+---+---+---+---+---+---+

+---+---+---+---+---+---+---+---+---+---+
|   | #   #   # |     # | #   #   # |   |
+   +---+---+---+---+   +   +---+   +---+
|           | #   #   # | # |   | #   # |
+---+---+---+---+---+---+---+---+---+---+

+---+---+---+---+---+---+---+---+---+---+
|   |   |               |       |       |
+   +   +   +---+---+---+---+---+   +   +
|       |       |                   |   |
+---+---+---+---+---+---+---+---+---+---+

+---+---+---+---+---+---+---+---+---+---+
|   |   |       |   | #   # |   |       |
+   +---+   +---+---+---+---+---+---+   +
|       |                   |   |   |   |
+---+---+---+---+---+---+---+---+---+---+

+---+---+---+---+---+---+---+---+---+---+
|   |   |   |       | # |       |       |
+   +---+   +---+   +---+   +---+   +---+
|   |       |       |   |   |       |   |
+---+---+---+---+---+---+---+---+---+---+

+---+---+---+---+---+---+---+---+---+---+
|   |           |     # |           |   |
+   +---+---+---+---+   +   +---+   +---+
|           | #   #   # |   |   |       |
+---+---+---+---+---+---+---+---+---+---+

+---+---+---+---+---+---+---+---+---+---+
|   | # |               | #   # |       |
+   +   +   +---+---+---+---+---+   +   +
|       |       |                   |   |
+---+---+---+---+---+---+---+---+---+---+

+---+---+---+---+---+---+---+---+---+---+
|   | # |       |   | #   # | # |       |
+   +---+   +---+---+---+---+---+---+   +
|       |                   |   |   |   |
+---+---+---+---+---+---+---+---+---+---+

+---+---+---+---+---+---+---+---+---+---+
|   | # |   | #   # | # | #   # |       |
+   +---+   +---+   +---+   +---+   +---+
|   |       | #   # |   | # |       |   |
+---+---+---+---+---+---+---+---+---+---+

+---+---+---+---+---+---+---+---+---+---+
|   | #   #   # |     # | #   #     |   |
+   +---+---+---+---+   +   +---+   +---+
|           | #   #   # | # |   |       |
+---+---+---+---+---+---+---+---+---+---+

