+---+---+---+---+---+---+---+---+---+---+---+---+---+---+
|       |   |                       |       |       |   |
+---+   +---+---+---+---+---+---+---+---+   +---+   +   +
|   |       |           |   |           |   |   |       |
+   +---+   +---+---+---+   +---+---+---+---+   +---+---+
|       |   | #   #         |           |   |   |       |
+   +   +---+   +   +---+---+---+---+---+   +---+   +---+
|   |   | #   # | # |                       |           |
+   +---+---+---+---+   +---+---+---+---+---+---+---+   +
|   | #   #   # |   |   |           |       |       |   |
+   +---+---+   +---+   +   +---+   +---+   +---+---+   +
|   |       | #   # |   |       |   |   |               |
+---+   +---+---+   +---+---+   +---+   +---+---+---+---+
|       | # | #   # |       |       |       | #   #   # |
+   +---+   +---+---+---+---+---+   +---+   +---+---+---+
|   | #   #     | #   # |       |       |       |       |
+   +---+---+---+   +   +---+   +---+---+---+---+---+---+
|       | #   #   # |       |                   |       |
+   +---+---+---+---+---+---+---+---+---+---+---+---+---+
|     #   #   # |   | #   # | #   #   #   #   #     |   |
+---+---+---+---+   +   +   +---+---+---+---+   +---+   +
| #   #   #   # |   | # | #   #   #     | #   # |       |
+---+---+---+---+---+---+---+---+---+---+---+---+---+---+

+---+---+---+---+---+---+---+---+---+---+---+---+---+---+
|           |   |               |       |       |   |   |
+---+---+   +   +   +---+---+   +---+---+---+---+   +   +
|           |   |   |   |   |       |   |       |   |   |
+---+   +---+---+---+   +   +---+   +   +---+---+   +---+
|       |               |           |   |       |   |   |
+---+---+---+---+---+---+---+---+---+---+---+---+   +   +
|       | # |   | #   # |       |               |   |   |
+   +---+   +   +---+   +   +   +   +---+---+   +---+   +
|   | #   # | #   #   # |   |       |       |   |       |
+   +---+---+   +---+---+   +---+---+---+   +---+---+---+
|   |   | #   #     |   |   |   |   |       |         # |
+   +   +   +---+   +   +   +   +   +---+---+---+   +   +
|       | # | # |   |   |   |   |   |     #   # |   | # |
+---+---+---+   +---+---+---+---+   +---+   +---+---+---+
| #   #     | #   #   # |       |   |   | # |       |   |
+   +---+---+---+---+---+---+   +   +   +   +---+---+   +
| # |   | #   #   #   #   # |       |   | # |       |   |
+   +---+---+---+---+---+   +---+---+   +   +---+---+---+
| # | # | #   #     | #   # | #   # |     # |       |   |
+   +   +---+---+---+   +   +---+   +---+   +   +---+   +
| # | #   #   # |   | # |       | # |   | # |       |   |
+---+---+---+---+---+---+---+---+---+---+---+---+---+---+

