+---+---+---+
| # |       |
+   +---+   +
| # |       |
+   +---+---+
| # |       |
+---+---+---+

+---+---+---+
|   | #   # |
+---+---+   +
|       | # |
+---+   +---+
| # |   |   |
+---+---+---+

+---+---+---+
|   | # |   |
+   +   +   +
|   | # | # |
+---+   +   +
| #   # | # |
+---+---+---+

